17
0 11 0 0 16 16 4032 1249 62 348
1 11 0 0 16 16 3585 1570 450 26
2 11 0 0 16 16 3584 1250 29 91
3 11 0 0 16 16 3587 1343 59 126
4 11 0 0 16 16 3647 1377 254 26
5 11 0 0 16 16 4032 866 63 344
6 11 0 0 16 16 3776 993 190 29
7 11 0 0 16 16 3776 1024 62 125
8 11 0 0 16 16 3711 1121 65 27
9 11 0 0 16 16 3648 1056 63 28
10 11 0 0 16 16 3456 993 192 26
11 11 0 0 16 16 3520 1024 93 188
12 11 0 0 16 16 3264 994 125 31
13 11 0 0 16 16 3327 1026 62 186
14 11 0 0 16 16 3200 1058 64 26
15 11 0 0 16 16 3936 1441 95 26
16 9 3686 1315 32 64 3649 1305 253 72
