43
0 11 0 0 16 16 3583 1249 33 219
1 11 0 0 16 16 3616 1342 31 126
2 11 0 0 16 16 3646 1377 256 28
3 11 0 0 16 16 3880 1378 16 27
4 11 0 0 16 16 3936 1442 97 27
5 11 0 0 16 16 3583 1444 63 23
6 11 0 0 16 16 4032 1247 62 351
7 11 0 0 16 16 3583 1569 448 27
8 11 0 0 16 16 3583 1118 31 290
9 3 3660 1267 32 32 3657 1259 364 183
10 9 3809 1313 32 64 3649 1293 253 84
11 12 3863 1264 32 32 3863 1264 32 32
12 12 3977 1448 32 32 3977 1448 32 32
13 12 3739 1445 32 32 3739 1445 32 32
14 16 3583 1470 32 96 3583 1470 32 96

15 11 0 0 16 16 4040 820 66 391
16 11 0 0 16 16 3972 1057 80 26
17 11 0 0 16 16 4040 1020 65 33
18 11 0 0 16 16 3776 993 191 28
19 11 0 0 16 16 3926 994 36 25
20 11 0 0 16 16 3776 1022 62 127
21 11 0 0 16 16 3711 1121 67 26
22 11 0 0 16 16 3648 1055 63 28
23 11 0 0 16 16 3458 991 190 64
24 11 0 0 16 16 3521 1022 92 191
25 11 0 0 16 16 3262 992 127 31
26 11 0 0 16 16 3328 1024 62 187
27 11 0 0 16 16 3199 1055 64 30
28 11 0 0 16 16 3008 993 126 27
29 11 0 0 16 16 2755 1042 356 264
30 11 0 0 16 16 2175 992 959 28
31 11 0 0 16 16 3071 862 30 31
32 9 3711 1056 32 64 3711 1056 65 66
33 12 3983 863 32 32 3981 864 31 31
34 12 3729 864 32 32 3726 863 29 31
35 12 3853 864 32 32 3857 864 30 31
36 12 3592 865 32 32 3589 866 28 29
37 12 3474 865 32 32 3473 865 27 30
38 12 3345 865 32 32 3347 869 28 27
39 12 3222 869 32 32 3220 873 25 19
40 16 3073 892 32 96 3073 892 32 96
41 9 3264 925 32 64 3262 925 127 66
42 17 3153 997 64 32 3133 992 131 28