144
0 11 0 0 16 16 3583 1249 33 219 0
1 11 0 0 16 16 3616 1342 31 126 0
2 11 0 0 16 16 3646 1377 256 28 0
3 11 0 0 16 16 3880 1378 16 27 0
4 11 0 0 16 16 3936 1442 97 27 0
5 11 0 0 16 16 3583 1444 63 23 0
6 11 0 0 16 16 4032 1247 62 351 0
7 11 0 0 16 16 3583 1569 448 27 0
8 11 0 0 16 16 3583 1118 31 290 0
9 3 3660 1267 32 32 3584 1248 510 176 0
10 9 3809 1313 32 64 3649 1293 253 84 0
11 12 3863 1264 32 32 3863 1264 32 32 32
12 12 3977 1448 32 32 3977 1448 32 32 31
13 12 3739 1445 32 32 3739 1445 32 32 24
14 16 3583 1470 32 96 3583 1470 32 96 31

15 11 0 0 16 16 4040 820 66 391 0
16 11 0 0 16 16 3972 1057 80 26 0
17 11 0 0 16 16 4040 1020 65 33 0
18 11 0 0 16 16 3776 993 191 28 0
19 11 0 0 16 16 3926 994 36 25 0
20 11 0 0 16 16 3776 1022 62 127 0
21 11 0 0 16 16 3711 1121 67 26 0
22 11 0 0 16 16 3648 1055 63 28 0
23 11 0 0 16 16 3458 991 190 64 0
24 11 0 0 16 16 3521 1022 92 191 0
25 11 0 0 16 16 3262 992 127 31 0
26 11 0 0 16 16 3328 1024 62 187 0
27 11 0 0 16 16 3199 1055 64 30 0
28 11 0 0 16 16 3008 993 126 27 0
29 11 0 0 16 16 2755 1042 356 264 0
30 11 0 0 16 16 2175 993 959 28 0
31 11 0 0 16 16 3071 862 30 31 0
32 9 3711 1056 32 64 3711 1056 65 66 0
33 12 3983 863 32 32 3981 864 31 31 30
34 12 3729 864 32 32 3726 863 29 31 30
35 12 3853 864 32 32 3857 864 30 31 30
36 12 3592 865 32 32 3589 866 28 29 30
37 12 3474 865 32 32 3473 865 27 30 30
38 12 3345 865 32 32 3347 869 28 27 32
39 12 3222 869 32 32 3220 873 25 19 30
40 16 3073 892 32 96 3073 892 32 96 0
41 9 3264 925 32 64 3262 925 127 66 31
42 17 3153 997 64 32 3133 992 131 28 0
143 3 3674 885 32 32 3454 863 636 159 0

43 11 0 0 16 16 2111 929 64 27 0
44 11 0 0 16 16 1599 992 511 30 0
45 11 0 0 16 16 1535 865 63 348 0
46 11 0 0 16 16 1597 927 64 29 0
47 12 2961 864 32 32 2961 864 32 32 30
48 12 2840 865 32 32 2840 865 32 32 32
49 12 2712 864 32 32 2712 864 32 32 32
50 12 2588 865 32 32 2588 865 32 32 30
51 12 2453 864 32 32 2453 864 32 32 25
52 12 2326 866 32 32 2326 866 32 32 32
53 12 2197 865 32 32 2197 865 32 32 30
54 12 2075 932 32 32 2075 932 32 32 31
55 12 1947 867 32 32 1947 867 32 32 30
56 12 1815 932 32 32 1815 932 32 32 31
57 12 1677 869 32 32 1677 869 32 32 30
58 6 2575 917 32 32 0 0 0 0 30
59 9 1950 930 32 64 1662 910 448 82 0

60 11 0 0 16 16 1568 481 31 92 0
61 11 0 0 16 16 1408 673 254 30 0
62 11 0 0 16 16 1567 703 32 126 0
63 11 0 0 16 16 1663 608 382 30 0
64 11 0 0 16 16 1728 769 62 29 0
65 11 0 0 16 16 1855 769 63 30 0
66 11 0 0 16 16 1982 736 127 30 0
67 11 0 0 16 16 2175 736 127 30 0
68 11 0 0 16 16 2239 608 62 30 0
69 11 0 0 16 16 2367 737 638 32 0
70 11 0 0 16 16 3007 480 64 350 0
71 11 0 0 16 16 2815 609 190 30 0
72 11 0 0 16 16 2685 671 66 30 0
73 11 0 0 16 16 2750 545 64 30 0
74 11 0 0 16 16 2237 608 64 30 0
75 11 0 0 16 16 2494 607 191 30 0
76 6 2000 700 32 32 1 0 0 0 0
77 6 2177 770 32 32 1 0 0 0 0
78 6 2250 691 32 32 1 0 0 0 0
79 9 2498 669 32 64 2367 667 319 69 0
80 9 2573 542 32 64 2494 541 191 67 0
81 9 2878 542 32 64 2813 542 191 67 0
82 12 1689 686 32 32 1689 686 32 32 30
83 12 1937 671 32 32 1937 671 32 32 30
84 12 2197 672 32 32 2197 672 32 32 30
85 12 1816 488 32 32 1816 488 32 32 30
86 12 2072 493 32 32 2072 493 32 32 30
87 12 2329 483 32 32 2329 483 32 32 30
88 12 2582 481 32 32 2582 481 32 32 30
89 12 2710 481 32 32 2710 481 32 32 30
90 12 2449 667 32 32 2449 667 32 32 30
91 12 2966 487 32 32 2966 487 32 32 30
92 12 2835 672 32 32 2835 672 32 32 30
93 17 2099 613 64 32 2044 610 193 27 0
94 17 2350 607 64 32 2301 608 192 29 0
95 16 1535 573 64 32 1534 573 33 102 0
141 6 1753 513 32 32 0 0 0 0 0
142 6 1600 530 32 32 0 0 0 0 0

96 11 0 0 16 16 1343 704 65 95 0
97 11 0 0 16 16 959 802 479 26 0
98 11 0 0 16 16 65 737 958 30 0
99 11 0 0 16 16 0 480 62 349 0
100 11 0 0 16 16 255 705 63 30 0
101 11 0 0 16 16 384 641 62 28 0
102 11 0 0 16 16 448 610 61 28 0
103 11 0 0 16 16 512 545 1085 26 0
104 11 0 0 16 16 1473 479 63 62 0
105 5 676 720 28 28 0 0 0 0 0
106 5 957 530 28 28 1 0 0 0 0
107 22 960 603 64 36 1 0 0 0 0
108 22 832 603 64 36 2 0 0 0 0
109 22 704 603 64 36 3 0 0 0 0
110 4 480 544 32 64 0 0 0 0 0
111 4 610 480 32 64 0 0 0 0 0
112 12 1302 678 32 32 0 0 0 0 30
113 12 1174 681 32 32 0 0 0 0 30
114 12 1045 679 32 32 0 0 0 0 30
115 12 918 682 32 32 0 0 0 0 30
116 12 793 686 32 32 0 0 0 0 30
117 12 662 682 32 32 0 0 0 0 30
118 12 537 683 32 32 0 0 0 0 30
119 12 410 670 32 32 0 0 0 0 30
120 12 283 669 32 32 0 0 0 0 30
121 12 151 620 32 32 0 0 0 0 30
122 3 280 547 32 32 64 529 448 205 0

123 6 971 276 32 32 0 0 0 0 0
124 6 576 219 32 32 0 0 0 0 0
125 16 1 253 64 32 1 253 64 32 0
126 12 1432 216 32 32 1425 212 22 24 30
127 12 1305 218 32 32 1298 215 30 22 30
128 12 1176 218 32 32 1172 219 19 13 30
129 12 1053 222 32 32 1040 217 23 13 30
130 12 918 221 32 32 907 221 26 11 30
131 12 794 223 32 32 784 218 24 15 30
132 12 669 223 32 32 660 219 21 17 30
133 12 408 236 32 32 401 234 22 15 30
134 12 108 586 32 32 0 0 0 0 30
135 11 0 0 16 16 1440 354 96 27 0
136 11 0 0 16 16 1471 95 62 254 0
137 11 0 0 16 16 448 320 959 28 0
138 11 0 0 16 16 1 354 446 28 0
139 11 0 0 16 16 1 98 63 155 0
140 0 190 260 0 0 0 0 0

