17
0 11 0 0 16 16 2560 320 766 29 0
1 11 0 0 16 16 3393 321 188 28 0
2 11 0 0 16 16 3647 321 254 30 0
3 11 0 0 16 16 3905 290 60 27 0
4 11 0 0 16 16 3968 257 1662 29 0
5 11 0 0 16 16 4033 97 126 61 0
6 11 0 0 16 16 2816 386 60 28 0
7 12 2759 264 32 32 2753 262 22 23 0
8 12 2875 200 32 32 2860 197 31 25 0
9 12 3130 203 32 32 3119 200 30 22 0
10 12 3895 203 32 32 3880 200 27 21 0
11 12 4026 200 32 32 4013 198 29 25 0
12 4 3269 258 32 64 3248 253 74 73 0
13 4 3799 258 32 64 3778 253 77 60 0
14 7 3089 165 32 24 3083 158 68 39 0
15 7 3515 288 32 24 3494 269 78 55 0
16 7 3648 293 32 24 3638 289 68 34 0