141
0 11 0 0 16 16 3583 1249 33 219
1 11 0 0 16 16 3616 1342 31 126
2 11 0 0 16 16 3646 1377 256 28
3 11 0 0 16 16 3880 1378 16 27
4 11 0 0 16 16 3936 1442 97 27
5 11 0 0 16 16 3583 1444 63 23
6 11 0 0 16 16 4032 1247 62 351
7 11 0 0 16 16 3583 1569 448 27
8 11 0 0 16 16 3583 1118 31 290
9 3 3660 1267 32 32 3657 1259 364 183
10 9 3809 1313 32 64 3649 1293 253 84
11 12 3863 1264 32 32 3863 1264 32 32
12 12 3977 1448 32 32 3977 1448 32 32
13 12 3739 1445 32 32 3739 1445 32 32
14 16 3583 1470 32 96 3583 1470 32 96

15 11 0 0 16 16 4040 820 66 391
16 11 0 0 16 16 3972 1057 80 26
17 11 0 0 16 16 4040 1020 65 33
18 11 0 0 16 16 3776 993 191 28
19 11 0 0 16 16 3926 994 36 25
20 11 0 0 16 16 3776 1022 62 127
21 11 0 0 16 16 3711 1121 67 26
22 11 0 0 16 16 3648 1055 63 28
23 11 0 0 16 16 3458 991 190 64
24 11 0 0 16 16 3521 1022 92 191
25 11 0 0 16 16 3262 992 127 31
26 11 0 0 16 16 3328 1024 62 187
27 11 0 0 16 16 3199 1055 64 30
28 11 0 0 16 16 3008 993 126 27
29 11 0 0 16 16 2755 1042 356 264
30 11 0 0 16 16 2175 993 959 28
31 11 0 0 16 16 3071 862 30 31
32 9 3711 1056 32 64 3711 1056 65 66
33 12 3983 863 32 32 3981 864 31 31
34 12 3729 864 32 32 3726 863 29 31
35 12 3853 864 32 32 3857 864 30 31
36 12 3592 865 32 32 3589 866 28 29
37 12 3474 865 32 32 3473 865 27 30
38 12 3345 865 32 32 3347 869 28 27
39 12 3222 869 32 32 3220 873 25 19
40 16 3073 892 32 96 3073 892 32 96
41 9 3264 925 32 64 3262 925 127 66
42 17 3153 997 64 32 3133 992 131 28

43 11 0 0 16 16 2111 929 64 27
44 11 0 0 16 16 1599 992 511 30
45 11 0 0 16 16 1535 865 63 348
46 11 0 0 16 16 1597 927 64 29
47 12 2961 864 32 32 2961 864 32 32
48 12 2840 865 32 32 2840 865 32 32
49 12 2712 864 32 32 2712 864 32 32
50 12 2588 865 32 32 2588 865 32 32
51 12 2453 864 32 32 2453 864 32 32
52 12 2326 866 32 32 2326 866 32 32
53 12 2197 865 32 32 2197 865 32 32
54 12 2075 932 32 32 2075 932 32 32
55 12 1947 867 32 32 1947 867 32 32
56 12 1815 932 32 32 1815 932 32 32
57 12 1677 869 32 32 1677 869 32 32
58 6 2575 917 32 32 2557 861 541 288
59 9 1950 925 32 64 1662 910 448 82

60 11 0 0 16 16 1568 481 31 92
61 11 0 0 16 16 1408 673 254 30
62 11 0 0 16 16 1567 703 32 126
63 11 0 0 16 16 1663 608 382 10
64 11 0 0 16 16 1728 769 62 29
65 11 0 0 16 16 1855 769 63 10
66 11 0 0 16 16 1982 736 127 10
67 11 0 0 16 16 2175 736 127 10
68 11 0 0 16 16 2239 608 62 10
69 11 0 0 16 16 2367 737 638 32
70 11 0 0 16 16 3007 480 64 350
71 11 0 0 16 16 2815 609 190 10
72 11 0 0 16 16 2685 671 66 10
73 11 0 0 16 16 2750 545 64 10
74 11 0 0 16 16 2237 608 64 10
75 11 0 0 16 16 2494 607 191 10
76 6 1994 700 32 32 1567 637 470 234
77 6 2177 770 32 32 1568 638 662 234
78 6 2250 691 32 32 1567 637 735 236
79 9 2498 669 32 64 2367 667 319 69
80 9 2573 542 32 64 2494 541 191 67
81 9 2878 542 32 64 2813 542 191 67
82 12 1689 686 32 32 1689 686 32 32
83 12 1937 671 32 32 1937 671 32 32
84 12 2197 672 32 32 2197 672 32 32
85 12 1816 488 32 32 1816 488 32 32
86 12 2072 493 32 32 2072 493 32 32
87 12 2329 483 32 32 2329 483 32 32
88 12 2582 481 32 32 2582 481 32 32
89 12 2710 481 32 32 2710 481 32 32
90 12 2449 667 32 32 2449 667 32 32
91 12 2966 487 32 32 2966 487 32 32
92 12 2835 672 32 32 2835 672 32 32
93 17 2099 613 64 32 2044 610 193 27
94 17 2350 607 64 32 2301 608 192 29
95 16 1535 573 64 32 1534 573 33 102

96 11 0 0 16 16 1343 704 65 95
97 11 0 0 16 16 959 802 479 26
98 11 0 0 16 16 65 737 958 30
99 11 0 0 16 16 0 480 62 349
100 11 0 0 16 16 255 705 63 30
101 11 0 0 16 16 384 641 62 28
102 11 0 0 16 16 448 610 61 28
103 11 0 0 16 16 512 545 1085 26
104 11 0 0 16 16 1473 479 63 62
105 5 676 720 28 28 0 0 0 0
106 5 957 530 28 28 1 0 0 0
107 22 960 603 64 36 1 0 0 0
108 22 832 603 64 36 2 0 0 0
109 22 704 603 64 36 3 0 0 0
110 4 480 544 32 64 0 0 0 0
111 4 610 480 32 64 0 0 0 0
112 12 1302 678 32 32 0 0 0 0
113 12 1174 681 32 32 0 0 0 0
114 12 1045 679 32 32 0 0 0 0
115 12 918 682 32 32 0 0 0 0
116 12 793 686 32 32 0 0 0 0
117 12 662 682 32 32 0 0 0 0
118 12 537 683 32 32 0 0 0 0
119 12 410 668 32 32 0 0 0 0
120 12 283 669 32 32 0 0 0 0
121 12 151 620 32 32 0 0 0 0
122 3 280 547 32 32 280 547 32 32

123 6 971 276 32 32 567 213 899 133
124 6 576 219 32 32 541 151 887 172
125 16 1 253 64 32 1 253 64 32
126 12 1432 216 32 32 1425 212 22 24
127 12 1305 218 32 32 1298 215 30 22
128 12 1176 218 32 32 1172 219 19 13
129 12 1053 222 32 32 1040 217 23 13
130 12 918 221 32 32 907 221 26 11
131 12 794 223 32 32 784 218 24 15
132 12 669 223 32 32 660 219 21 17
133 12 408 236 32 32 401 234 22 15
134 12 108 586 32 32 0 0 0 0
135 11 0 0 16 16 1440 354 96 27
136 11 0 0 16 16 1471 95 62 254
137 11 0 0 16 16 448 320 959 28
138 11 0 0 16 16 1 354 446 28
139 11 0 0 16 16 1 98 63 155
140 0 190 260 0 0 0 0

