21
0 11 0 0 16 16 1 355 445 25
1 11 0 0 16 16 448 321 958 27
2 11 0 0 16 16 1470 97 64 346
3 11 0 0 16 16 1472 482 128 91
4 11 0 0 16 16 511 544 959 28
5 11 0 0 16 16 447 610 62 27
6 11 0 0 16 16 384 643 62 24
7 11 0 0 16 16 256 704 62 29
8 11 0 0 16 16 0 482 62 345
9 11 0 0 16 16 63 738 959 27
10 11 0 0 16 16 960 764 62 65
11 11 0 0 16 16 1024 803 573 28
12 11 0 0 16 16 1344 706 253 92
13 11 0 0 16 16 1409 674 251 25
14 11 0 0 16 16 1675 105 41 1161
15 5 359 268 32 64 1 283 444 69
16 5 78 281 32 64 0 280 446 73
17 5 1089 253 32 64 448 235 958 88
18 5 1197 260 32 64 447 235 956 87
19 5 1304 259 32 64 448 236 959 85
