171 128 51 32 32 
  0   0   0   0   0   0   0   0   0   0   0   0   0   0   0   0   0   0   0   0   0   0   0   0   0   0   0   0   0   0   0   0   0   0   0   0   0   0   0   0   0   0   0   0   0   0   0   0   0   0   0   0   0   0   0   0   0   0   0   0   0   0   0   0   0   0   0   0   0   0   0   0   0   0   0   0   0   0   0   0   0   0   0   0   0   0   0   0   0   0   0   0   0   0   0   0   0   0   0   0   0   0   0   0   0   0   0   0   0   0   0   0   0   0   0   0   0   0   0   0   0   0   0   0   0   0   0   0 
  0   0   0   0   0   0   0   0   0   0   0   0   0   0   0   0   0   0   0   0   0   0   0   0   0   0   0   0   0   0   0   0   0   0   0   0   0   0   0   0   0   0   0   0   0   0   0   0   0   0   0   0   0   0   0   0   0   0   0   0   0   0   0   0   0   0   0   0   0   0   0   0   0   0   0   0   0   0   0   0   0   0   0   0   0   0   0   0   0   0   0   0   0   0   0   0   0   0   0   0   0   0   0   0   0   0   0   0   0   0   0   0   0   0   0   0   0   0   0   0   0   0   0   0   0   0   0   0 
  0   0   0   0   0   0   0   0   0   0   0   0   0   0   0   0   0   0   0   0   0   0   0   0   0   0   0   0   0   0   0   0   0   0   0   0   0   0   0   0   0   0   0   0   0   0   0   0   0   0   0   0   0   0   0   0   0   0   0   0   0   0   0   0   0   0   0   0   0   0   0   0   0   0   0   0   0   0   0   0   0   0   0   0   0   0   0   0   0   0   0   0   0   0   0   0   0   0   0   0   0   0   0   0   0   0   0   0   0   0   0   0   0   0   0   0   0   0   0   0   0   0   0   0   0   0   0   0 
  1   1   0   0   0   0   2   3   0   0   0   0   4   5   6   7   6   7   6   7   6   7   6   7   6   7   6   7   6   7   6   7   6   7   6   7   6   7   6   7   6   7   6   7   6   7   1   1   0   0   0   0   0   0   0   0   0   0   0   0   0   0   0   0   0   0   0   0   0   0   0   0   0   0   0   0   0   0   0   0   0   0   0   0   0   0   0   0   0   0   0   0   0   0   0   0   0   0   0   0   0   0   0   0   0   0   0   0   0   0   0   0   0   0   0   0   0   0   0   0   0   0   0   0   0   0   0   0 
  1   1   0   0   0   0   8   8   0   0   0   0   4   5   9  10   9  10  11  12  13  14  11  12  15  16  11  12  15  16  11  12  15  16  11  12  15  16  11  12  15  16  11  12  17  17   1   1   0   0   0   0   0   0   0   0   0   0   0   0   0   0   0   0   0   0   0   0   0   0   0   0   0   0   0   0   0   0   0   0   0   0   0   0   0   0   0   0   0   0   0   0   0   0   0   0   0   0   0   0   0   0   0   0   0   0   0   0   0   0   0   0   0   0   0   0   0   0   0   0   0   0   0   0   0   0   0   0 
  1   1   0   0  18  19   8   8  18  19   0   0   4   5   6   7   6   7   0   0   4   5   0   0   4   5   0   0   4   5   0   0   4   5   0   0   4   5   0   0   4   5   0   0  17  17   1   1   0   0   0   0   0   0   0   0   0   0   0   0   0   0   0   0   0   0   0   0   0   0   0   0   0   0   0   0   0   0   0   0   0   0   0   0   0   0   0   0   0   0   0   0   0   0   0   0   0   0   0   0   0   0   0   0   0   0   0   0   0   0   0   0   0   0   0   0   0   0   0   0   0   0   0   0   0   0   0   0 
  1   1   0   0  20  21   8   8  20  21   0   0   4   5  17  17  17  17  22  23   4   5  22  23   4   5  22  23   4   5  22  23   4   5  22  23   4   5  22  23   4   5  22  23  17  17   1   1   0   0   0   0   0   0   0   0   0   0   0   0   0   0   0   0   0   0   0   0   0   0   0   0   0   0   0   0   0   0   0   0   0   0   0   0   0   0   0   0   0   0   0   0   0   0   0   0   0   0   0   0   0   0   0   0   0   0   0   0   0   0   0   0   0   0   0   0   0   0   0   0   0   0   0   0   0   0   0   0 
  1   1  18  19  20  21   8   8  20  21  18  19   4   5  17  17  17  17  24  25   4   5  24  25   4   5  24  25   4   5  24  25   4   5  24  25   4   5  24  25   4   5  24  25  17  17   1   1   0   0   0   0   0   0   0   0   0   0   0   0   0   0   0   0   0   0   0   0   0   0   0   0   0   0   0   0   0   0   0   0   0   0   0   0   0   0   0   0   0   0   0   0   0   0   0   0   0   0   0   0   0   0   0   0   0   0   0   0   0   0   0   0   0   0   0   0   0   0   0   0   0   0   0   0   0   0   0   0 
 26  27  20  21  20  21  28  29  20  21  20  21   4   5  17  17  17  17  30  25   4   5  30  25   4   5  30  25   4   5  30  25   4   5  30  25   4   5  30  25   4   5  30  25  17  17   1   1   0   0   0   0   0   0   0   0   0   0   0   0   0   0   0   0   0   0   0   0   0   0   0   0   0   0   0   0   0   0   0   0   0   0   0   0   0   0   0   0   0   0   0   0   0   0   0   0   0   0   0   0   0   0   0   0   0   0   0   0   0   0   0   0   0   0   0   0   0   0   0   0   0   0   0   0   0   0   0   0 
 31  32  20  21  20  21  33  34  20  21  20  21   4   5  17  17  17  17  24  25   4   5  24  25   4   5  24  25   4   5  24  25   4   5  24  25   4   5  24  25   4   5  24  25  17  17   1   1   0   0   0   0   0   0   0   0   0   0   0   0   0   0   0   0   0   0   0   0   0   0   0   0   0   0   0   0   0   0   0   0   0   0   0   0   0   0   0   0   0   0   0   0   0   0   0   0   0   0   0   0   0   0   0   0   0   0   0   0   0   0   0   0   0   0   0   0   0   0   0   0   0   0   0   0   0   0   0   0 
 35  36  37  38  37  38  39  40  37  38  37  38   4   5   1   1   1   1   1   1   1   1   1   1   1   1   1   1   1   1   1   1   1   1   1   1   1   1   1   1   1   1   1   1  17  17   1   1   0   0   0   0   0   0   0   0   0   0   0   0   0   0   0   0   0   0   0   0   0   0   0   0   0   0   0   0   0   0   0   0   0   0   0   0   0   0   0   0   0   0   0   0   0   0   0   0   0   0   0   0   0   0   0   0   0   0   0   0   0   0   0   0   0   0   0   0   0   0   0   0   0   0   0   0   0   0   0   0 
  1   1   1   1   1   1   1   1   1   1   1   1   1   1  17  17  17  17  17  17  17  17  17  17  17  17  17  17  17  17  17  17  17  17  17  17  17  17  17  17  17  17  17  17  41   1   1   1   0   0   0   0   0   0   0   0   0   0   0   0   0   0   0   0   0   0   0   0   0   0   0   0   0   0   0   0   0   0   0   0   0   0   0   0   0   0   0   0   0   0   0   0   0   0   0   0   0   0   0   0   0   0   0   0   0   0   0   0   0   0   0   0   0   0   0   0   0   0   0   0   0   0   0   0   0   0   0   0 
  9  10   9  10   9  10   9  10   9  10   9  10   9  10   9  10   9  10  11  12  15  16  11  12  15  16  11  12  15  16  11  12  15  16  11  12  15  16  11  12  15  16  42  43  17  17   1   1   0   0   0   0   0   0   0   0   0   0   0   0   0   0   0   0   0   0   0   0   0   0   0   0   0   0   0   0   0   0   0   0   0   0   0   0   0   0   0   0   0   0   0   0   0   0   0   0   0   0   0   0   0   0   0   0   0   0   0   0   0   0   0   0   0   0   0   0   0   0   0   0   0   0   0   0   0   0   0   0 
  6   7   6   7   6   7   6   7   6   7   6   7   6   7   6   7   6   7   0   0   4   5   0   0   4   5   0   0   4   5   0   0   4   5   0   0   4   5   0   0   4   5  43  17  17  17   1   1   0   0   0   0   0   0   0   0   0   0   0   0   0   0   0   0   0   0   0   0   0   0   0   0   0   0   0   0   0   0   0   0   0   0   0   0   0   0   0   0   0   0   0   0   0   0   0   0   0   0   0   0   0   0   0   0   0   0   0   0   0   0   0   0   0   0   0   0   0   0   0   0   0   0   0   0   0   0   0   0 
  0   0   0   0   0   0   0   0   0   0   0   0   0   0   0   0   0   0   0   0   0   0   0   0   0   0   0   0   0   0   0   0   0   0   0   0   0   0   0   0   0   0   0   0   0   0   0   0   0   0   0   0   0   0   0   0   0   0   0   0   0   0   0   0   0   0   0   0   0   0   0   0   0   0   0   0   0   0   0   0   0   0   0   0   0   0   0   0   0   0   0   0   0   0   0   0   0   0   0   0   0   0   0   0   0   0   0   0   0   0   0   0   0   0   0   0   0   0   0   0   0   0   0   0   0   0   0   0 
  1   1   6   7   6   7   6   7   6   7   6   7   6   7   6   7  17  17   0   0   4   5   0   0   4   5   0   0   4   5   0   0   4   5   0   0   4   5   0   0  17  17  43  17  17  17   1   1   1   1   4   5  44  45   4   5  17  46  47  48  49  50  47  51  52  53  54  54  54  55  56  57  54  46  47  48  49  50  47  58  54  46  47  58  54  46  47  58  54  46  47  48  49  59  60  61   0   0   0   0   0   0   0   0   0   0   0   0   0   0   0   0   0   0   0   0   0   0   0   0   0   0   0   0   0   0   0   0 
  1   1  11  12  15  16  11  12  15  16  11  12  15  16  11  12  62  63   0   0   4   5   0   0   4   5   0   0   4   5   0   0   4   5   0   0   4   5   0   0  42  43  62  63  64  65   1   1   1   1   4   5  17  17   4   5  66  67  47  58  54  46  47  68  69  70  54  54  54  54  54  71  72  67  47  68  69  73  47  58  54  46  47  58  54  46  47  74  72  67  47  48  75  76  60  61   0   0   0   0   0   0   0   0   0   0   0   0   0   0   0   0   0   0   0   0   0   0   0   0   0   0   0   0   0   0   0   0 
  1   1   0   0   4   5   0   0   4   5   0   0   4   5   0   0   1   1   1   1   1   1   1   1   1   1   1   1   1   1   1   1   1   1   1   1   1   1   1   1   1   1   1   1   1   1   1   1   1   1   4   5  17  17   4   5  44  50  47  58  54  46  47  77  56  57  54  54  54  54  54  78  49  50  47  77  56  79  47  58  54  46  47  58  54  80  60  81  49  50  47  51  52  82  60  61   0   0   0   0   0   0   0   0   0   0   0   0   0   0   0   0   0   0   0   0   0   0   0   0   0   0   0   0   0   0   0   0 
  1   1  37  37   4   5  37  37   4   5  37  37   4   5   0   0  17  17  11  12  15  16  83  84  15  16  83  84  15  16  83  84  15  16  11  12  15  16  11  12   4   5  17  17  17  17  85  86  26  27   4   5  64  65   4   5  64  87  47  58  88  87  47  58  54  54  54  71  72  89  88  90  54  46  47  48  75  91  47  58  88  87  47  74  72  67  47  58  88  87  47  51  52  82  60  61   0   0   0   0   0   0   0   0   0   0   0   0   0   0   0   0   0   0   0   0   0   0   0   0   0   0   0   0   0   0   0   0 
  1   1  37  37   4   5  37  37   4   5  37  37   4   5   1   1  17  17   0   0   4   5  92  93   4   5  94  95   4   5  94  95   4   5   0   0   4   5   0   0   4   5  17  17  17  17  96  97  31  32   4   5   1   1   1   1   1  60  60  60  60  60  60  98  54  54  54  78  49  59  60  98  54  46  47  51  52  82  60  60  60  60  60  81  49  50  47  99  60  60  60  60  60  60  60  61   0   0   0   0   0   0   0   0   0   0   0   0   0   0   0   0   0   0   0   0   0   0   0   0   0   0   0   0   0   0   0   0 
  1   1  37  37   4   5  37  37   4   5 100 101   1   1  17  17 102  27   0   0   4   5  94  95   4   5   0   0   4   5   0   0   4   5  37  37   4   5  37  37   4   5  17  17  62  63  64  65  35  36   4   5  85  86  15  16  11 103 104 105 106 103 104 107  54  54  54  54  54 108 104 109  75 110 111 112 106 103 104 105 106 113  47  51  52 114 111 112 106 103 104 105 106 115  60  61   0   0   0   0   0   0   0   0   0   0   0   0   0   0   0   0   0   0   0   0   0   0   0   0   0   0   0   0   0   0   0   0 
  1   1  37  37   4   5  37  37   4   5 101  17  17  17  17  17  62  63   0   0   4   5   0   0   4   5   0   0   4   5   0   0   4   5  37  37   4   5  37  37   4   5  17  17   1   1   1   1   1   1   1   1  96  97   4   5   0   0  47 116   0   0  47  58  54  54  54  54  54  46  47  51  52 117  47 116   0   0  47 116   0   0  47  99  60  61  47 116   0   0  47 116   0 118  60  61   0   0   0   0   0   0   0   0   0   0   0   0   0   0   0   0   0   0   0   0   0   0   0   0   0   0   0   0   0   0   0   0 
  1   1  37  38   4   5  37  38   1   1  62  63  64  65  64  65  62  63   0   0   4   5   0   0   4   5   0   0   4   5   0   0   4   5  37  37   4   5  37  37   4   5   1   1   1   1   1   1   1   1  13  14  66 119   4   5  17  46  47  58  54  46  47  51  52 120  72  89  88  87  47  68 121 122  47  51  52 117  47  58  88  87  47  58  88  87  47  58  88  87  47  58  88 123  60  61   0   0   0   0   0   0   0   0   0   0   0   0   0   0   0   0   0   0   0   0   0   0   0   0   0   0   0   0   0   0   0   0 
  1   1   1   1   1   1   1   1   1   1   1   1   1   1   1   1   1   1   1   1   1   1   1   1   1   1   1   1   1   1   1   1   4   5  37  37   4   5  37  37   4   5   1   1   1   1   1   1   1   1   4   5  44  45   4   5  17  46  47  58  54  80  60  60  60  81  49  59  60  60  60 124 125 126  60  60  60  60  60  60  60  60  60  60  60  60  60  60  60  60  60  60  60  60  60  61   0   0   0   0   0   0   0   0   0   0   0   0   0   0   0   0   0   0   0   0   0   0   0   0   0   0   0   0   0   0   0   0 
  1   1   9  10   9  10   9  10   9  10   9  10   9  10   9  10   9  10   9  10   9  10   9  10   9  10   9  10   9  10   1   1   4   5  37  38   4   5  37  38   4   5   1   1   1   1   1   1   1   1   4   5  42  43   1   1  85 127  60 128 106 103 104 105 106 113   0 129 106 103 104 130   0 131 104 105 106 103 104 105 106 103 104 105 106 103 104 105 106 103 104 105 106 115  60  61   0   0   0   0   0   0   0   0   0   0   0   0   0   0   0   0   0   0   0   0   0   0   0   0   0   0   0   0   0   0   0   0 
  1   1   6   7   6   7   6   7   6   7   6   7   6   7   6   7   6   7   6   7   6   7   6   7   6   7   6   7   6   7   1   1   1   1   1   1   1   1   1   1   1   1   1   1   1   1   1   1   1   1   4   5  43  17  13 132  96 133 111 134   0   0  47 116   0   0   0   0   0   0  47 116   0   0  47 116   0   0  47 116   0   0  47 116   0   0  47 116   0   0  47 116   0 118  60  61   0   0   0   0   0   0   0   0   0   0   0   0   0   0   0   0   0   0   0   0   0   0   0   0   0   0   0   0   0   0   0   0 
  0   0   0   0   0   0   0   0   0   0   0   0   0   0   0   0   0   0   0   0   0   0   0   0   0   0   0   0   0   0   0   0   0   0   0   0   0   0   0   0   0   0   0   0   0   0   0   0   0   0   0   0   0   0   0   0   0   0   0   0   0   0   0   0   0   0   0   0   0   0   0   0   0   0   0   0   0   0   0   0   0   0   0   0   0   0   0   0   0   0   0   0   0   0   0   0   0   0   0   0   0   0   0   0   0   0   0   0   0   0   0   0   0   0   0   0   0   0   0   0   0   0   0   0   0   0   0   0 
  0   0   0   0   0   0   0   0   0   0   0   0   0   0   0   0   0   0   0   0   0   0   0   0   0   0   0   0   0   0   0   0   0   0   0   0   0   0   0   0   0   0   0   0   0   0   0   0   1   1   4   5  43  17   4   5  17  46  47  58  54  46  47  58  54  46  47  58  54  54  54  54  54  46  47  48  49  50  47  58  54  46  47  58  54  46  47  58  54  46  47  58  54  46  47  99  98  78  49 135  56  79  47  58  54  55  56 136  49 137  54  46  47  58  54  78  49  50  47  58  54  54  54  78  49  59  60  60 
  0   0   0   0   0   0   0   0   0   0   0   0   0   0   0   0   0   0   0   0   0   0   0   0   0   0   0   0   0   0   0   0   0   0   0   0   0   0   0   0   0   0   0   0   0   0   0   0   1   1   4 138  17  17   4   5  17  46  47  48  75  91  47  58  54  46  47  58  54  54  54  71  72  67  47  58  54  46  47  58  54  46  47  58  54  46  47  58  54  46  47  58  54  46  47 116 139 140  69  70  54  46  47  48  75 141  72  89  54  54  54  46  47  74  72  89  54  46  47  48  75 141  72  89  54  80  60  60 
  0   0   0   0   0   0   0   0   0   0   0   0   0   0   0   0   0   0   0   0   0   0   0   0   0   0   0   0   0   0   0   0   0   0   0   0   0   0   0   0   0   0   0   0   0   0   0   0   1   1   1   1  17  17   4   5  17  46  47  51  52 117  47  58  54  80  60  98  54  54  54  78  49  50  47  58  54  46  47  58  54  46  47  58  54  46  47  58  54  46  47  58  54  46  47 116 142 143  56  57  54  46  47  51  52 144  49 137  54  54  54  46  47  48  49 137  54  46  47  51  52 144  49 137  54  80  60  60 
  0   0   0   0   0   0   0   0   0   0   0   0   0   0   0   0   0   0   0   0   0   0   0   0   0   0   0   0   0   0   0   0   0   0   0   0   0   0   0   0   0   0   0   0   0   0   0   0   1   1   4   5  64  65   4   5  64  87  47  51  52 117  47  58  88  87  47  58  88 145  52 146  52 117  47  58  88  87  47  58  88  87  47  51  52 117  47  51  52 117  47  58  88  87  47 116 147 148  54  71  72  67  47  51  52  53  54  54  88  90  88  87  47  68  69  70  54  46  47  51  52  53  88  90  54  80  60  60 
  0   0   0   0   0   0   0   0   0   0   0   0   0   0   0   0   0   0   0   0   0   0   0   0   0   0   0   0   0   0   0   0   0   0   0   0   0   0   0   0   0   0   0   0   0   0   0   0   1   1   1   1   1   1   1   1   1  60  60  60  60  60  60  60  60  61  47  99  60  60  60  60  60  60  60  60  60  60  60  60  60  60  60  60  60  60  60  60  60  60  60  60  60  60  60  60  60  98  54  78  49  59  60  60  60  98  54  80  60  60  60  60  60 149  56  57  54  80  60  60  60  60  60  98  54  80  60  60 
  0   0   0   0   0   0   0   0   0   0   0   0   0   0   0   0   0   0   0   0   0   0   0   0   0   0   0   0   0   0   0   0   0   0   0   0   0   0   0   0   0   0   0   0   0   0   0   0   1   1   4   5  11  12  15  16  11 103 104 105 106 103 104 105 106 103 104 105 106 103 104 105 106 103 104 105 106 103 104 105 106 103 104 105 106 103 104 105 106 103 104 105 106 115  60  60  98  54  54 150  52 117  47  99  60  98  54  54  54  80  60  60  98  54  88 151  75  76  60 152  69 153  75 154  54  80  60  60 
  0   0   0   0   0   0   0   0   0   0   0   0   0   0   0   0   0   0   0   0   0   0   0   0   0   0   0   0   0   0   0   0   0   0   0   0   0   0   0   0   0   0   0   0   0   0   0   0   1   1   4   5   0   0   4   5   0   0  47 116   0   0  47 116   0   0  47 116   0   0  47 116   0   0  47 116   0   0  47 116   0   0  47 116   0   0  47 116   0   0  47 116   0 118  60  60  98  54  54  80  60  61  47  99  60  98  54  54  54  80  60  60  98  80  60 155  52  82  60 149  56 156  52 157 158  60  60  60 
  0   0   0   0   0   0   0   0   0   0   0   0   0   0   0   0   0   0   0   0   0   0   0   0   0   0   0   0   0   0   0   0   0   0   0   0   0   0   0   0   0   0   0   0   0   0   0   0   1   1   4   5  66 119   4   5  66  67  47  74  72  67  47  74  72  67  47  74  72  67  47  74  72  67  47  74  72  67  47  74  72  67  47  74  72  67  47  74  72  67  47  74  72 159  60  60  98  71  72 160  69  73  47  99  60  98  54  71  72 159  60  60  98  54  54 150  52  82  60  98  54  54 161 162  47  99  60  60 
  0   0   0   0   0   0   0   0   0   0   0   0   0   0   0   0   0   0   0   0   0   0   0   0   0   0   0   0   0   0   0   0   0   0   0   0   0   0   0   0   0   0   0   0   0   0   0   0   1   1   4   5  44  45   4   5  44  50  47  48  49  50  47  48  49  50  47  48  49  50  47  48  49  50  47  48  49  50  47  48  49  50  47  48  49  50  47  48  49  50  47  48  49  59  60  60  98  78  49 135  56  79  47  99  60  98  54  78  49  59  60  60  98  54  54  80  60  60  60  98  54 163 164  46  47  99  60  60 
  0   0   0   0   0   0   0   0   0   0   0   0   0   0   0   0   0   0   0   0   0   0   0   0   0   0   0   0   0   0   0   0   0   0   0   0   0   0   0   0   0   0   0   0   0   0   0   0   1   1   4   5  85  86   4   5  17  46  47  68  69  73  47  68  69  73  47  48  75  91  47  58  54  46  47  68  69  73  47  58  54  46  47  68  69  73  47  58  54  46  47  68  69 127  60  60  98  78  75 154  54  46  47  99  60  98  54  54  54  80  60  60  98  54  54  54  54  54  54  54 161 164  54  46  47  99  60  60 
  0   0   0   0   0   0   0   0   0   0   0   0   0   0   0   0   0   0   0   0   0   0   0   0   0   0   0   0   0   0   0   0   0   0   0   0   0   0   0   0   0   0   0   0   0   0   0   0   1   1   4   5  96  97   4   5  17  46  47  77  56  79  47  77  56  79  47  51  52 117  47  58  54  46  47  77  56  79  47  58  54  46  47  77  56  79  47  58  54  46  47  77  56 165  60  60  98 150  52  53  54  46  47  99  60  98  54  54  54  80  60  60  98  54  54  54  54  54  54 163 164  54  54  46  47  99  60  60 
  0   0   0   0   0   0   0   0   0   0   0   0   0   0   0   0   0   0   0   0   0   0   0   0   0   0   0   0   0   0   0   0   0   0   0   0   0   0   0   0   0   0   0   0   0   0   0   0   0   0   0   0   0   0   0   0   0   0   0   0   0   0   0   0   0   0   0   0   0   0   0   0   0   0   0   0   0   0   0   0   0   0   0   0   0   0   0   0   0   0   0   0   0   0   0   0   0   0   0   0   0   0   0   0   0   0   0   0   0   0   0   0   0   0   0   0   0   0   0   0   0   0   0   0   0   0   0   0 
  0   0   0   0   0   0   0   0   0   0   0   0   0   0   0   0   0   0   0   0   0   0   0   0   0   0   0   0   0   0   0   0   0   0   0   0   0   0   0   0   0   0   0   0   0   0   0   0   0   0   0   0   0   0   0   0   0   0   0   0   0   0   0   0   0   0   0   0   0   0   0   0   0   0   0   0   0   0   0   0   0   0   0   0   0   0   0   0   0   0   0   0   0   0   0   0   0   0   0   0   0   0   0   0   0   0   0   0   0   0   0 118  98  46  47  58  54  54  54 163 164 150  52 117  47  99  60  60 
  0   0   0   0   0   0   0   0   0   0   0   0   0   0   0   0   0   0   0   0   0   0   0   0   0   0   0   0   0   0   0   0   0   0   0   0   0   0   0   0   0   0   0   0   0   0   0   0   0   0   0   0   0   0   0   0   0   0   0   0   0   0   0   0   0   0   0   0   0   0   0   0   0   0   0   0   0   0   0   0   0   0   0   0   0   0   0   0   0   0   0   0   0   0   0   0   0   0   0   0   0   0   0   0   0   0   0   0   0   0   0 118  98  46  47  58  54  54 161 164  54 166  69  73  47  99  60  60 
  0   0   0   0   0   0   0   0   0   0   0   0   0   0   0   0   0   0   0   0   0   0   0   0   0   0   0   0   0   0   0   0   0   0   0   0   0   0   0   0   0   0   0   0   0   0   0   0   0   0   0   0   0   0   0   0   0   0   0   0   0   0   0   0   0   0   0   0   0   0   0   0   0   0   0   0   0   0   0   0   0   0   0   0   0   0   0   0   0   0   0   0   0   0   0   0   0   0   0   0   0   0   0   0   0   0   0   0   0   0   0 118  98  46  47  58  54 163 164  54  54  55  56  79  47  99  60  60 
  0   0   0   0   0   0   0   0   0   0   0   0   0   0   0   0   0   0   0   0   0   0   0   0   0   0   0   0   0   0   0   0   0   0   0   0   0   0   0   0   0   0   0   0   0   0   0   0   0   0   0   0   0   0   0   0   0   0   0   0   0   0   0   0   0   0   0   0   0   0   0   0   0   0   0   0   0   0   0   0   0   0   0   0   0   0   0   0   0   0   0   0   0   0   0   0   0   0   0   0   0   0   0   0   0   0   0   0   0   0   0 118  60  61  47  58 161 167  52  53  88  90  54  46  47  99  60  60 
  0   0   0   0   0   0   0   0   0   0   0   0   0   0   0   0   0   0   0   0   0   0   0   0   0   0   0   0   0   0   0   0   0   0   0   0   0   0   0   0   0   0   0   0   0   0   0   0   0   0   0   0   0   0   0   0   0   0   0   0   0   0   0   0   0   0   0   0   0   0   0   0   0   0   0   0   0   0   0   0   0   0   0   0   0   0   0   0   0   0   0   0   0   0   0   0   0   0   0   0   0   0   0   0   0   0   0   0   0   0   0 118  60  60  60  60  60  60  60  60  60  98  54  46  47  99  60  60 
  0   0   0   0   0   0   0   0   0   0   0   0   0   0   0   0   0   0   0   0   0   0   0   0   0   0   0   0   0   0   0   0   0   0   0   0   0   0   0   0   0   0   0   0   0   0   0   0   0   0   0   0   0   0   0   0   0   0   0   0   0   0   0   0   0   0   0   0   0   0   0   0   0   0   0   0   0   0   0   0   0   0   0   0   0   0   0   0   0   0   0   0   0   0   0   0   0   0   0   0   0   0   0   0   0   0   0   0   0   0   0 118  60  61  47  68  69  70  54  54  54  54  54  46  47  99  60  60 
  0   0   0   0   0   0   0   0   0   0   0   0   0   0   0   0   0   0   0   0   0   0   0   0   0   0   0   0   0   0   0   0   0   0   0   0   0   0   0   0   0   0   0   0   0   0   0   0   0   0   0   0   0   0   0   0   0   0   0   0   0   0   0   0   0   0   0   0   0   0   0   0   0   0   0   0   0   0   0   0   0   0   0   0   0   0   0   0   0   0   0   0   0   0   0   0   0   0   0   0   0   0   0   0   0   0   0   0   0   0   0 118  60  61  47  77  56  57  54  54  54 168 158  60  60  60  60  60 
  0   0   0   0   0   0   0   0   0   0   0   0   0   0   0   0   0   0   0   0   0   0   0   0   0   0   0   0   0   0   0   0   0   0   0   0   0   0   0   0   0   0   0   0   0   0   0   0   0   0   0   0   0   0   0   0   0   0   0   0   0   0   0   0   0   0   0   0   0   0   0   0   0   0   0   0   0   0   0   0   0   0   0   0   0   0   0   0   0   0   0   0   0   0   0   0   0   0   0   0   0   0   0   0   0   0   0   0   0   0   0   0 139  91  47  58  54  54  54  54 161 164  54  78  75  76  60  60 
  0   0   0   0   0   0   0   0   0   0   0   0   0   0   0   0   0   0   0   0   0   0   0   0   0   0   0   0   0   0   0   0   0   0   0   0   0   0   0   0   0   0   0   0   0   0   0   0   0   0   0   0   0   0   0   0   0   0   0   0   0   0   0   0   0   0   0   0   0   0   0   0   0   0   0   0   0   0   0   0   0   0   0   0   0   0   0   0   0   0   0   0   0   0   0   0   0   0   0   0   0   0   0   0   0   0   0   0   0   0   0   0 142 169  47  58  54  54  54 163 164  54  54 150  52  82  60  60 
  0   0   0   0   0   0   0   0   0   0   0   0   0   0   0   0   0   0   0   0   0   0   0   0   0   0   0   0   0   0   0   0   0   0   0   0   0   0   0   0   0   0   0   0   0   0   0   0   0   0   0   0   0   0   0   0   0   0   0   0   0   0   0   0   0   0   0   0   0   0   0   0   0   0   0   0   0   0   0   0   0   0   0   0   0   0   0   0   0   0   0   0   0   0   0   0   0   0   0   0   0   0   0   0   0   0   0   0   0   0   0   0 147 170  47  51  52  53 161 164  88  90  88 145  52  82  60  60 
  0   0   0   0   0   0   0   0   0   0   0   0   0   0   0   0   0   0   0   0   0   0   0   0   0   0   0   0   0   0   0   0   0   0   0   0   0   0   0   0   0   0   0   0   0   0   0   0   0   0   0   0   0   0   0   0   0   0   0   0   0   0   0   0   0   0   0   0   0   0   0   0   0   0   0   0   0   0   0   0   0   0   0   0   0   0   0   0   0   0   0   0   0   0   0   0   0   0   0   0   0   0   0   0   0   0   0   0   0   0   0 118  60  60  60  60  60  60  60  60  60  60  60  60  60  60  60  60 
  0   0   0   0   0   0   0   0   0   0   0   0   0   0   0   0   0   0   0   0   0   0   0   0   0   0   0   0   0   0   0   0   0   0   0   0   0   0   0   0   0   0   0   0   0   0   0   0   0   0   0   0   0   0   0   0   0   0   0   0   0   0   0   0   0   0   0   0   0   0   0   0   0   0   0   0   0   0   0   0   0   0   0   0   0   0   0   0   0   0   0   0   0   0   0   0   0   0   0   0   0   0   0   0   0   0   0   0   0   0   0   0   0   0   0   0   0   0   0   0   0   0   0   0   0   0   0   0 
