63
0 11 0 0 16 16 4032 1249 62 348
1 11 0 0 16 16 3585 1570 450 26
2 11 0 0 16 16 3584 1250 29 91
3 11 0 0 16 16 3587 1343 59 126
4 11 0 0 16 16 3647 1377 254 26
5 11 0 0 16 16 4032 866 63 344
6 11 0 0 16 16 3776 993 190 29
7 11 0 0 16 16 3776 1024 62 125
8 11 0 0 16 16 3711 1121 65 27
9 11 0 0 16 16 3648 1056 63 28
10 11 0 0 16 16 3456 993 192 26
11 11 0 0 16 16 3520 1024 93 188
12 11 0 0 16 16 3264 994 125 31
13 11 0 0 16 16 3327 1026 62 186
14 11 0 0 16 16 3200 1058 64 26
15 11 0 0 16 16 3936 1441 95 26
16 9 3686 1315 32 64 3649 1305 253 72
17 9 3680 1504 32 64 3649 1504 253 72
18 11 0 0 16 16 3967 1056 62 28
0 11 0 0 16 16 3072 865 31 28
1 11 0 0 16 16 3133 1306 1 100
2 11 0 0 16 16 2175 992 959 29
3 11 0 0 16 16 3008 1026 93 186
4 11 0 0 16 16 2111 930 62 26
5 11 0 0 16 16 1599 994 510 27
6 11 0 0 16 16 1599 930 64 26
7 11 0 0 16 16 1535 865 64 347
8 11 0 0 16 16 1727 770 64 27
9 11 0 0 16 16 1855 769 63 28
10 11 0 0 16 16 1984 737 123 26
11 11 0 0 16 16 1664 609 381 28
12 11 0 0 16 16 1882 980 31 16
13 11 0 0 16 16 2175 738 126 28
14 11 0 0 16 16 2367 740 638 24
15 11 0 0 16 16 2495 609 191 28
16 11 0 0 16 16 2686 674 65 28
17 11 0 0 16 16 2753 546 61 29
18 11 0 0 16 16 2818 610 188 27
19 11 0 0 16 16 3009 479 60 348
20 11 0 0 16 16 2239 608 63 29
21 11 0 0 16 16 1409 674 253 27
22 11 0 0 16 16 1345 706 255 123
23 11 0 0 16 16 1025 801 318 29
24 11 0 0 16 16 961 739 63 89
25 11 0 0 16 16 64 738 898 26
26 11 0 0 16 16 1 483 62 344
27 11 0 0 16 16 259 705 60 28
28 11 0 0 16 16 385 642 60 26
29 11 0 0 16 16 449 608 61 30
30 11 0 0 16 16 511 545 958 27
31 11 0 0 16 16 1472 480 127 91
32 11 0 0 16 16 1471 98 63 346
33 11 0 0 16 16 448 323 959 24
34 11 0 0 16 16 1420 352 50 29
35 11 0 0 16 16 1 355 445 27
36 11 0 0 16 16 0 96 64 157
37 9 3711 1058 32 64 3709 1051 67 69
38 9 3265 943 32 64 3261 929 127 66
39 11 0 0 16 16 3158 991 76 14
41 9 1919 912 32 64 1664 926 445 69
42 6 2576 911 32 32 2558 862 549 200
0 6 3587 1414 32 32 3576 1409 514 156