1	3583	1249	551	350	15	0 1 2 3 4 5 6 7 8 9 10 11 12 13 14
2	3170	865	1203	350	27	15 16 17 18 19 20 21 22 23 24 25 26 27 28 30 31 32 33 34 35 36 37 38 39 40 41 42
3	1335	865	1567	350	20	30 31 40 43 44 45 46 47 48 49 50 51 52 53 54 55 56 57 58 59
4	1537	481	1535	350	38	60 61 62 63 64 65 66 67 68 69 70 71 72 73 74 75 76 77 78 79 80 81 82 83 84 85 86 87 88 89 90 91 92 93 94 95 141 142
5	0	481	1570	350	29	61 95 96 97 98 99 100 101 102 103 104 105 106 107 108 109 110 111 112 113 114 115 116 117 118 119 120 121 122
6	0	96	1535	350	18	123 124 125 126 127 128 129 130 131 132 133 134 135 136 137 138 139 140