47
0 11 0 0 16 16 2560 320 766 32 0
1 11 0 0 16 16 3393 321 188 32 0
2 11 0 0 16 16 3647 321 254 32 0
3 11 0 0 16 16 3905 290 60 32 0
4 11 0 0 16 16 3968 257 1662 32 0
5 11 0 0 16 16 4033 97 126 61 0
6 11 0 0 16 16 2816 386 60 32 0
7 12 2759 264 32 32 2753 262 22 23 0
8 12 2875 200 32 32 2860 197 31 25 0
9 12 3130 203 32 32 3119 200 30 22 0
10 12 3895 203 32 32 3880 200 27 21 0
11 12 4026 200 32 32 4013 198 29 25 0
12 4 3269 258 32 64 3248 253 74 73 0
13 4 3799 258 32 64 3778 253 77 60 0
14 7 3089 165 32 32 3083 158 68 39 0
15 7 3515 288 32 32 3494 269 78 55 0
16 7 3648 293 32 32 3638 289 68 34 0
17 16 4060 157 32 96 0 0 0 0 0

18 11 0 0 16 16 5698 256 52 32 0
19 11 0 0 16 16 5820 258 60 32 0
20 11 0 0 16 16 5956 256 697 32 0
21 11 0 0 16 16 6531 95 58 60 0
22 11 0 0 16 16 6531 291 189 32 0
23 11 0 0 16 16 6721 321 30 32 0
24 11 0 0 16 16 6752 355 30 32 0
25 11 0 0 16 16 6657 417 509 32 0
26 11 0 0 16 16 6527 322 65 120 0
27 12 4158 197 32 32 4151 192 45 45 0
28 12 6582 197 32 32 6565 191 35 32 0
29 12 6840 295 32 32 6826 290 33 28 0
30 12 6966 296 32 32 6947 295 41 22 0
31 12 7104 302 32 32 7089 295 34 30 0
32 12 6713 199 32 32 6703 193 29 27 0
33 7 4613 142 32 24 4603 133 37 45 0
34 7 4804 137 32 24 4795 135 51 36 0
35 7 5057 117 32 24 5054 117 37 32 0
36 7 5188 122 32 24 5173 121 54 29 0
37 4 4893 194 64 32 4893 185 37 71 0
38 4 5429 194 64 32 5421 182 53 74 0
39 4 6417 194 64 32 6411 190 43 64 0
40 6 6237 147 32 32 5880 125 428 179 0
41 6 6600 160 32 32 6134 126 571 160 0
42 8 5698 191 32 64 5663 174 124 175 0
43 8 5837 182 32 64 5802 167 115 155 0
46 11 0 0 16 16 7165 170 65 250 0
44 1 6718 337 32 80 1 0 0 0 0
45 1 7000 337 32 80 2 0 0 0 0