24
0 11 0 0 16 16 1 401 1533 11
1 11 0 0 16 16 1535 414 3168 28
2 11 0 0 16 16 4736 415 384 27
3 11 0 0 16 16 4863 291 98 26
4 11 0 0 16 16 4319 225 542 27
5 11 0 0 16 16 4592 95 32 30
6 11 0 0 16 16 4592 255 32 157
7 11 0 0 16 16 3392 290 191 25
8 11 0 0 16 16 3038 223 321 27
9 11 0 0 16 16 2911 289 97 28
10 11 0 0 16 16 5119 256 129 189
11 11 0 0 16 16 5248 258 62 27
12 11 0 0 16 16 5312 289 95 24
13 11 0 0 16 16 5246 416 97 27
14 11 0 0 16 16 5374 417 1791 25
15 11 0 0 16 16 6978 350 60 30
16 11 0 0 16 16 7072 290 93 27
17 11 0 0 16 16 5888 290 348 26
18 11 0 0 16 16 5440 225 413 26
19 11 0 0 16 16 5614 254 16 160
20 11 0 0 16 16 5566 98 63 27
21 5 459 330 32 64 390 328 148 61
22 5 271 330 32 64 197 308 207 87
