85 81 11 32 32 
  0   1   2   3   4   5   6   3   7   8   6   3   7   8   6   3   7   8   6   3   7   8   8   8   8   8   6   3   9  10  11   3   7   8   6   3   7   8   6   3   7   8   6   3   7   8   6   3   0  12  13  10  14  15  16   3   7   8  17  15  18  10   7   8   6   3   7   8  13  10  11   3   7   8   8   8  13  10   0   1   1 
  0   1   2  19   5   8   6   3   7   8   6   3  20  21   6   3   7   8   6   3   7   8   8   8  22  23  24   3   7   8   6   3   7   8   6   3   7   8   6   3   7   8   6   3   7   8   6   3  25  26  27  28  29   8   6   3  20  21  22  23  30   8   8   8   6   3  31  23  30   8   6   3  20  21  22  23  30   8  32   1   1 
  0   1   1   1  12   8   6   3   7   8   6   3  33  34   6   3   7   8  32   1  12   8   8   8  13  10  11   3   7   8   6   3   7   8   6   3   7   8   6   3   7   8   6   3   7   8   6   3  35  36  14  15  37   8   6   3  33  34  13  10   7   8   8   8   6   3   9  10   7   8   6   3  33  34  13  10   7   8  32   1   1 
  0   1   2   3  38  39   6   3  38  39   6   3  33  34   6   3  38  39   6   3  38  39  40  34  40  34   6   3  38  39   6   3  38  39   6   3  33  34   6   3  33  34   6   3  38  39   6   3  41  42   7   8  22  23  24   3  33  34   8   8  43  39  43  39   6   3  44  28  29   8   6   3  33  34  43  39   8   8  32   1   1 
  0   1   1   1   1   1   1   1   1   1   1   1   1   1   1   1   1   1   2   3   0   1   1   1   1   1   1   1   1   1   1   1   1   1   1   1   1   1   1   1   1   1   1   1   1   1   1   1   1   1  12   8  13  10   0   1   1   1  12   8  32   1   1   1   1   1  45  15  37   8  32   1   1   1   1   1  12   8  32   1   1 
  0   1   2   3  46  47  48  49  50  47  48  49  50  47  48  49  50  47  48  49  50  47  48  49  50  47  48  49  50  47  48  49  50  47  48  49  50  47  48  49  50  47  48  49  50  47  51   1   1  12   8   8  40  34   6   3   0   1  12   8   8   8  32   1   1  12  43  39  52  21  32   1  53  28  54  21   8   8  32   1   1 
  0   1   2   3  55  55  11   3  55  55  11   3  55  55  11   3  55  55  11   3  55  55  11   3  55  55  11   3  55  55  11   3  55  55  11   3  55  55  11   3  55  55  11   3  55  55   0   1   1  12   8   8  32   1   2   3   0   1  12   8   8   8  32   1   1  12  32   1  56  34  32   1  45  15  57  34  58  59   1   1   1 
  0   1   2   3  31  23  24   3  31  23  24   3  31  23  24   3  31  23  24   3  31  23  24   3  31  23  24   3  31  23  24   3  31  23  24   3  31  23  24   3  31  23  24   3  31  23  60   1   1  12  22  23  61  28  62   3   0   1  12   8  22  23  60   1   1  12   8   8  40  34  32   1  12   8  63  64  65   3   0   1   1 
  0   1   2   3   9  10  11   3   9  10  11   3   9  10  11   3   9  10  11   3   9  10  11   3   9  10  11   3   9  10  11   3   9  10  11   3   9  10  11   3   9  10  11   3   9  10   0   1   1  12  13  10  14  15  16   3   0   1  12   8  13  10   0   1   1  12   8   8  32   1   1   1  12   8  64   5   6   3   0   1   1 
  0   1   2   3  44  28  62   3   7   8   6   3  44  28  62   3  44  28  62   3  20  21   6   3   7   8   6   3  44  28  62   3   7   8   6   3  44  28  62   3   7   8   6   3  44  28  66   1   1  12  52  21   8   8   6   3   0   1  12   8   8   8  32   1   1  12   8   8   8   8   8   8  63  64   5   8   6   3   0   1   1 
 67  68  69  70  71  72  73  70  74  75  76  70  71  72  73  70  71  72  73  70  77  78  76  70  74  75  76  70  71  72  73  70  74  75  76  70  71  72  73  70  74  75  76  70  71  72  79  68  68  80  81  78  75  75  76  70  67  68  80  75  75  75  82  68  68  80  75  75  75  75  75  75  83  84  75  75  76  70  67  68  68 
