126 176 10 16 16 
  0   1   2   3   4   5   0   1   0   1   2   3   4   5   0   1   0   1   2   3   6   7   0   1   0   1   2   3   4   5   0   1   8   9   2   3   4   5   8   9   0   1   0   1   0   1   0   1   2   3   4   5  10  10   2   3  11  12   0   1   0   1   8   9   2   3   8   9   2   3   8   9   2   3   8   9   2   3   0   1   8   9   0   1  11  12  11  12   0   1  10  10   2   3  13  14  15  16  16  16  16  16   2   3  16  16  16  16  16  16  16  16  17  18  16  16  17  18  16  16  16  16  16  16  16  16  19  19   0   1   0   1   2   3  11  12   0   1   2   3   8   9   0   1   2   3   4   5  20  21  22  23   0   1  24  25   2   3  22  23   0   1  24  25   2   3  22  23   0   1   6   7   8   9  13  14 
 26  27  28  29  30  31  32  33  34  35  28  29  30  31  32  33  34  35  28  29  36  37  32  33  34  35  28  29  30  31  32  33  26  27  28  29  30  31  38  38  34  35  34  35  34  35  34  35  28  29  39  40  38  38  28  29  34  35  34  35  34  35  26  27  28  29  38  38  28  29  38  38  28  29  38  38  28  29  34  35  38  38  34  35  34  35  34  35  34  35  38  38  28  29  41  42  43  41  41  44  41  41  28  45  41  41  46  41  46  41  46  41  28  45  41  44  28  29  41  41  41  41  46  41  46  41  41  42  34  35  26  27  28  29  34  35  34  35  28  29  38  38  34  35  28  29  30  31  26  27  34  35  47  48  49  50  28  29  51  52  47  48  49  50  28  29  51  52  47  48  36  37  38  38  53  54 
 55  56  28  29  57  58  59  60  61  62  28  29  57  58  59  60  61  62  28  29  63  64  59  60  61  62  28  29  57  58  59  60  55  56  28  29  57  58  38  38  61  62  61  62  61  62  61  62  28  29  65  66  38  38  28  29  61  62  61  62  61  62  55  56  28  29  38  38  28  29  38  38  28  29  38  38  28  29  61  62  38  38  61  62  61  62  61  62  61  62  38  38  28  29  41  67  43  41  68  69  41  41  70  45  41  41  41  41  41  41  41  41  70  45  68  69  28  29  41  41  41  41  41  41  41  41  41  67  61  62  55  56  28  29  61  62  61  62  28  29  38  38  61  62  28  29  57  58  55  56  61  62  28  29  71  72  28  29  73  74  28  29  71  72  28  29  73  74  28  29  63  64  38  38  75  54 
 34  35  28  29  39  40  38  38  34  35  28  29  30  31  38  38  34  35  28  29  30  31  38  38  34  35  28  29  30  31  38  38  34  35  28  29  30  31  38  38  34  35  34  35  76  77  78  79  80  81  82  83  84  84  84  84  85  86  87  88  34  35  34  35  28  29  38  38  28  29  38  38  28  29  38  38  28  29  32  33  38  38  34  35  76  77  78  79  84  84  82  83  80  81  41  89  43  41  41  41  41  41  80  81  41  41  41  41  90  91  90  91  28  29  90  91  28  29  41  41  41  44  41  41  41  41  41  89  82  83  84  84  84  84  85  86  87  88  28  29  38  38  34  35  28  29  39  40  34  35  34  35  28  29  34  35  28  29  34  35  28  29  34  35  28  29  32  33  28  29  39  40  38  38  41  42 
 61  62  28  29  65  66  38  38  61  62  28  29  57  58  38  38  61  62  28  29  57  58  38  38  61  62  28  29  57  58  38  38  61  62  28  29  57  58  38  38  61  62  61  62  92  78  93  94  94  94  94  94  94  94  94  94  94  95  96  97  61  62  61  62  28  29  38  38  28  29  38  38  28  29  38  38  28  29  59  60  38  38  61  62  92  78  93  94  94  94  94  94  94  94  94  94  94  94  94  94  94  94  94  94  41  41  41  41  43  98  43  98  28  29  43  98  28  29  41  41  68  69  94  94  94  94  94  94  94  94  94  94  94  94  94  95  96  97  28  29  38  38  61  62  28  29  65  66  61  62  61  62  28  29  61  62  28  29  61  62  28  29  61  62  28  29  59  60  28  29  65  66  38  38  41  67 
 34  35  28  29  34  35  38  38  34  35  28  29  39  40  38  38  32  33  28  29  30  31  38  38  34  35  28  29  39  40  38  38  34  35  28  29  30  31  38  38  76  77  78  79  99  93 100 101  28  29  34  35  26  27  28  29 102 103  95 104  82  83  84  84  28  29  38  38  28  29  38  38  28  29  38  38  28  29  26  27  38  38  76  77 105  93 100 101  34  35  34  35  47  48  53  54 106  41  90  91  90  91  28  29  41  41  84 107  41  41  90  91 108 109 108 109  94  94  41  41  84 107  41  41  41  44 110 111  36  37  34  35  47  48 102 103  95 104  84  84  82  83  84  84  84  84  85  86  87  88  34  35  28  29  34  35  28  29  34  35  28  29  34  35  28  29  26  27  28  29  76  77  78  79  41  89 
 61  62  28  29  61  62  38  38  61  62  28  29  65  66  38  38  59  60  28  29  57  58  38  38  61  62  28  29  65  66  38  38  61  62  28  29  57  58  38  38  92  78  93  94  94  94 112 113  28  29  61  62  55  56  28  29 114 115  94  94  94  94  94  94  28  29  38  38  28  29  38  38  28  29  38  38  28  29  55  56  38  38  92  78  93 116 112 113  61  62  61  62  28  29  75  54 106  41  43  98  43  98  28  29  94  94  94 117 118 119  43  98 109 109 109 109  47  48  94  94  94 117 118 119  68  69 110 111  63  64  61  62  28  29 114 115  94  94  94  94  94  94  94  94  94  94  94  95  96  97  61  62  28  29  61  62  28  29  61  62  28  29  61  62  28  29  55  56  28  29  92  78  93  94  94  94 
 34  35  28  29  34  35  38  38  32  33  28  29  34  35  38  38  26  27  28  29  39  40  38  38  34  35  28  29  34  35  38  38  26  27  28  29  39  40  76  77 105  93 100 101  32  33  34  35  28  29  34  35  34  35  28  29  34  35  28  29  32  33  32  33  28  29  38  38  28  29  38  38  28  29  38  38  28  29  32  33  76  77 105  93 100 101  32  33  34  35  34  35  28  29  53  54 106  41  41  41  41  41  28  45  90  91  28  29  95 107  41  41 108 109 108 109  28  45  90  91  28  29  95 107  41  41 110 111  39  40  34  35  28  29  34  35  32  33  28  29  26  27  28  29  26  27 102 103  95  96  87  88  28  29  34  35  28  29  34  35  28  29  34  35  28  29  34  35  28  29  99  93 100 101  53  54 
 61  62  28  29  61  62  38  38  59  60  28  29  61  62  38  38  55  56  28  29  65  66  38  38  61  62  28  29  61  62  38  38  55  56  28  29  65  66  92  78  93 116 112 113  59  60  61  62  28  29  61  62  61  62  28  29  61  62  28  29  59  60  59  60  28  29  38  38  28  29  38  38  28  29  38  38  28  29  59  60  92  78  93 116 112 113  59  60  61  62  61  62  28  29  75  54 106  41  41  41  41  41  70  45  43  98  28  29 120  95 118 119 109 109 109 109  70  45  43  98  28  29 120  95 118 119 110 111  65  66  61  62  28  29  61  62  59  60  28  29  55  56  28  29  55  56 114 115 121  95  96  97  28  29  61  62  28  29  61  62  28  29  61  62  28  29  61  62  28  29  94  94 112 113  75  54 
 82  83  80  81  82  83  82  83  82  83  80  81  82  83  82  83  82  83  80  81  82  83  82  83  82  83  80  81  82  83  82  83  82  83  80  81  82  83  99  93  82  83  82  83  82  83  82  83  80  81  82  83  82  83  80  81  82  83  80  81  82  83  82  83  80  81  82  83  80  81  82  83  80  81  82  83  80  81  82  83  99  93  82  83  82  83  82  83  82  83  82  83  80  81 122  54 106  41  84 107  41  41  80  81  41  41  80  81  41 123  95 124 108 109 108 109  80  81  84 107  80  81  41 123  95 124 125 111  82  83  82  83  80  81  82  83  82  83  80  81  82  83  80  81  82  83  82  83  82  83  95 104  80  81  82  83  80  81  82  83  80  81  82  83  80  81  82  83  80  81  82  83  82  83 122  54 
 94  94  94  94  94  94  94  94  94  94  94  94  94  94  94  94  94  94  94  94  94  94  94  94  94  94  94  94  94  94  94  94  94  94  94  94  94  94  94  94  94  94  94  94  94  94  94  94  94  94  94  94  94  94  94  94  94  94  94  94  94  94  94  94  94  94  94  94  94  94  94  94  94  94  94  94  94  94  94  94  94  94  94  94  94  94  94  94  94  94  94  94  94  94  94  94  94  94  94  95  94  94  94  94  94  94  94  94  94  94  94  94 106 106 106 106  94  94  94  95  94  94  94  94  94  94  94  94  94  94  94  94  94  94  94  94  94  94  94  94  94  94  94  94  94  94  94  94  94  94  94  94  94  94  94  94  94  94  94  94  94  94  94  94  94  94  94  94  94  94  94  94  94  94  94  94 
